Assets/Tileset/spritesheet.png
142
13 11
15 15
105
121 105 105 105 105 105 105 105 105 105 105 105 105 105 105
105 44 44 44 44 44 44 44 44 44 44 44 44 105 72
105 106 105 106 105 106 105 106 105 106 105 106 105 105 44
105 105 106 105 106 105 106 105 106 105 106 105 106 105 44
105 106 105 106 105 106 105 106 105 106 105 106 105 105 44
105 105 106 105 106 105 106 105 106 105 106 105 106 105 44
105 106 105 106 105 106 105 106 105 106 105 106 105 105 44
105 105 106 105 106 105 106 105 106 105 106 105 106 105 44
105 106 105 106 105 106 105 106 105 106 105 106 105 105 44
105 105 106 105 106 105 106 105 106 105 106 105 106 105 44
105 106 105 106 105 106 105 106 105 106 105 106 105 105 44
105 105 106 105 106 105 106 105 106 105 106 105 106 105 44
105 106 105 106 105 106 105 106 105 106 105 106 105 105 44
105 105 106 105 106 105 106 105 106 105 106 105 106 105 44
105 105 105 105 105 105 105 105 105 105 105 105 105 105 50
